11111111111111111111111111
10000000000000000000000001
10000000000000000000000001
11111111000111111000111111
10000000000110000000000001
10000000000110000000000001
11000111111111000111111111
10000000000110000000000001
10000000000110000000000001
11111111111111111111111111
11111111111111111111111111
10000000000000000000000001
10000000000000000000000001
11111111111100011110001111
10000000000000000110000001
10000000000000000110000001
11111100011111111111110001
10000000000011000000000001
10000000000011000000000001
11111111111111111111111111
11111111111111111111111111
10000000000000000000000001
10000000000000000000000001
10001111000111111111111111
10000011000001100000000001
10000011000001100000000001
11100011110001100011110001
10000011000000000011000001
10000011000000000011000001
11111111111111111111111111
11111111111111111111111111
10000000000000000000000001
10000000000000000000000001
10001111111111111111000111
10000000000000000011000001
10000000000000000011000001
11111111111111100011110001
10000000000000000011000001
10000000000000000011000001
11111111111111111111111111
11111111111111111111111111
10000000000000000000000001
10000000000000000000000001
11111111100011110001111111
10000000000000000000000001
10000000000000000000000001
10001111000111111000110001
10000011000000000000110001
10000011000000000000110001
11111111111111111111111111
11111111111111111111111111
10000000000000000000000001
10000000000000000000000001
10001111000000000011110001
10000011000001100011000001
10000011000000000011000001
11100011110000000011000111
10000011000000000011000001
10000011000000000011000001
11111111111111111111111111
11111111111111111111111111
10000000000000000000000001
10000000000000000000000001
11100011111111111111110001
10000000000000000011000001
10000000000000000011000001
11111111000111100011000111
10000000000110000011000001
10000000000110000011000001
11111111111111111111111111
11111111111111111111111111
10000000000000000000000001
10000000000000000000000001
11100011111111111111110001
10000011000000000000000001
10000011000000000000000001
10001111000111111111111111
10000011000000000000000001
10000011000000000000000001
11111111111111111111111111